{
  "": "粼",
  "": "点",
  "": "性",
  "": "稜",
  "": "德",
  "": "癰",
  "": "难",
  "": "瑮",
  "": "歘",
  "": "活",
  "": "信",
  "": "重",
  "": "逫",
  "": "鶸",
  "": "盩",
  "": "楗",
  "": "鉧",
  "": "解",
  "": "纝",
  "": "遫",
  "": "懘",
  "": "鋲",
  "": "便",
  "": "鑝",
  "": "鋌",
  "": "鰯",
  "": "海",
  "": "位",
  "": "毨",
  "": "篯",
  "": "暽",
  "": "鶲",
  "": "縺",
  "": "繺",
  "": "在",
  "": "踳",
  "": "鏦",
  "": "鵽",
  "": "谿",
  "": "惤",
  "": "孏",
  "": "燊",
  "": "鱴",
  "": "觉",
  "": "往",
  "": "縌",
  "": "话",
  "": "碍",
  "": "兢",
  "": "邋",
  "": "靉",
  "": "自",
  "": "銑",
  "": "嬿",
  "": "鐽",
  "": "饊",
  "": "鸃",
  "": "縈",
  "": "逡",
  "": "年",
  "": "每",
  "": "庶",
  "": "譢",
  "": "鐙",
  "": "豯",
  "": "鼲",
  "": "絰",
  "": "爨",
  "": "嶕",
  "": "蘻",
  "": "繸",
  "": "魙",
  "": "爇",
  "": "繙",
  "": "者",
  "": "黸",
  "": "鰎",
  "": "齉",
  "": "鐩",
  "": "敠",
  "": "鶅",
  "": "勷",
  "": "瀠",
  "": "许",
  "": "鐎",
  "": "国",
  "": "缴",
  "": "郧",
  "": "绐",
  "": "欻",
  "": "纐",
  "": "音",
  "": "瑟",
  "": "鍵",
  "": "遒",
  "": "鹴",
  "": "鑶",
  "": "輱",
  "": "绬",
  "": "穫",
  "": "齾",
  "": "驎",
  "": "縻",
  "": "狿",
  "": "轗",
  "": "瀚",
  "": "扠",
  "": "殎",
  "": "鰄",
  "": "遮",
  "": "蘕",
  "": "鷵",
  "": "龘",
  "": "鰜",
  "": "竅",
  "": "蕯",
  "": "鐷",
  "": "魔",
  "": "貗",
  "": "胀",
  "": "韉",
  "": "繳",
  "": "硍",
  "": "鼢",
  "": "纙",
  "": "騝",
  "": "捉",
  "": "白",
  "": "蹙",
  "": "伱",
  "": "鸐",
  "": "毲",
  "": "覊",
  "": "樋",
  "": "燚",
  "": "爦",
  "": "毿",
  "": "鼸",
  "": "櫷",
  "": "厲",
  "": "萎",
  "": "褬",
  "": "蠛",
  "": "鶶",
  "": "最",
  "": "漖",
  "": "礹",
  "": "蠮",
  "": "権",
  "": "櫉",
  "": "橪",
  "": "撫",
  "": "麣",
  "": "佐",
  "": "騳",
  "": "馦",
  "": "繊",
  "": "攧",
  "": "蕀",
  "": "廯",
  "": "灟",
  "": "餼",
  "": "藱",
  "": "蹆",
  "": "皫",
  "": "叇",
  "": "鐉",
  "": "外",
  "": "繋",
  "": "薕",
  "": "寫",
  "": "爊",
  "": "邈",
  "": "緻",
  "": "纞",
  "": "翷",
  "": "鶁",
  "": "蘶",
  "": "觏",
  "": "猣",
  "": "熟",
  "": "橥",
  "": "麴",
  "": "鰢",
  "": "韍",
  "": "果",
  "": "隟",
  "": "螶",
  "": "骜",
  "": "鵜",
  "": "葌",
  "": "斀",
  "": "戠",
  "": "隲",
  "": "渢",
  "": "镳",
  "": "孅",
  "": "黱",
  "": "烸",
  "": "蓮",
  "": "蟏",
  "": "鐐",
  "": "騰",
  "": "黁",
  "": "燧",
  "": "鸞",
  "": "衟",
  "": "殲",
  "": "鸊",
  "": "鸝",
  "": "窳",
  "": "蘇",
  "": "嗷",
  "": "奋",
  "": "逖",
  "": "藜",
  "": "齺",
  "": "塋",
  "": "鎢",
  "": "与",
  "": "嫺",
  "": "廆",
  "": "燹",
  "": "勿",
  "": "熬",
  "": "蠭",
  "": "闅",
  "": "嬲",
  "": "蘨",
  "": "馫",
  "": "脅",
  "": "迉",
  "": "蒥",
  "": "檮",
  "": "鋆",
  "": "飈",
  "": "逊",
  "": "窭",
  "": "琁",
  "": "遰",
  "": "鱡",
  "": "磀",
  "": "鎎",
  "": "阋",
  "": "唫",
  "": "礘",
  "": "巕",
  "": "摦",
  "": "勼",
  "": "魫",
  "": "僞",
  "": "埑",
  "": "闿",
  "": "篶",
  "": "魟",
  "": "餛",
  "": "仟",
  "": "几",
  "": "煐",
  "": "濁",
  "": "孨",
  "": "轎",
  "": "鶐",
  "": "禭",
  "": "熨",
  "": "澾",
  "": "腾",
  "": "扢",
  "": "劚",
  "": "礣",
  "": "踟",
  "": "穱",
  "": "糹",
  "": "悹",
  "": "岔",
  "": "溬",
  "": "鮂",
  "": "阅",
  "": "凡",
  "": "轟",
  "": "蕴",
  "": "遇",
  "": "紳",
  "": "盁",
  "": "正",
  "": "颸",
  "": "了",
  "": "搌",
  "": "磓",
  "": "斷",
  "": "鐼",
  "": "鱐",
  "": "詵",
  "": "鐋",
  "": "擝",
  "": "嚠",
  "": "!",
  "": "憷",
  "": "鷐",
  "": "攕",
  "": "鸔",
  "": "濚",
  "": "攍",
  "": "惔",
  "": "獁",
  "": "辚",
  "": "瓦",
  "": "颻",
  "": "f",
  "": "镸",
  "": "蓾",
  "": "闖",
  "": "瓙",
  "": "憀",
  "": "炃",
  "": "摰",
  "": "＋",
  "": "墕",
  "": "獨",
  "": "鵆",
  "": "鑻",
  "": "仍",
  "": "u",
  "": "赒",
  "": "驘",
  "": "逛",
  "": "贬",
  "": "魞",
  "": "劅",
  "": "瀏",
  "": "壆",
  "": "願",
  "": "擲",
  "": "奉",
  "": "樊",
  "": "趰",
  "": "愱",
  "": "摫",
  "": "踋",
  "": "竀",
  "": "︰",
  "": "嶨",
  "": "尖",
  "": "闼",
  "": "鷽",
  "": "氼",
  "": "粪",
  "": "蚇",
  "": "馴",
  "": "业",
  "": "廬",
  "": "洼",
  "": "藁",
  "": "諾",
  "": "酺",
  "": "巤",
  "": "搆",
  "": "慌",
  "": "竽",
  "": "仇",
  "": ":",
  "": "‥"
}